You are a newly appointed historian and your first job is to clean up the archives. This is where you stumble upon the ghost of Tevarus of Tanner, a former aristocrat with very little recorded history to his name. The only thing you remember about him is the fact that he died a traitor's death.

He does not seem dangerous and neither does he appear to have noticed you.

Tevarus
An attempt at IF by anonabelle
Release 1 / Serial number 241213 / Inform 7 v10.1.2 / D

Archives
The archives are located near the top of one of the smaller towers. Shelves high as the ceiling line the cylindrical walls, each of them crammed with records that are centuries old - and smells it. Maybe you should air out the room.

Seated at the single table by the window is Tevarus.

I beg your pardon?

>z
Time passes.

>z
Time passes.

>x
(Tevarus)
He does not appear to have noticed you, his pensive gaze trained outside the window.

>help
That's not a verb I recognise.

>x archives
You can't see any such thing.

>look at archives
You can't see any such thing.

>x table
It is made of wood, and is circular in dimension, more like the tables set out in the gardens than one used for extensive studying.

>x chair
It is fancy looking, guilded with leaves and intricate designs. Again, unlike the kind used for studying. Tevarus is currently occupying it, though you have no idea how this is possible as he is somewhat transparent.

>x tev
He does not appear to have noticed you, his pensive gaze trained outside the window. Maybe you should get his attention.

* * *

>Tevarus
That's not a verb I recognise.

>x tevarus
He does not appear to have noticed you, his pensive gaze trained outside the window.

>z
Time passes.

>x table
It is made of wood, and is circular in dimension, more like the tables set out in the gardens than one used for extensive studying. It has a single chair, which Tevarus is occupying.

>hello
(Tevarus)
"Ho, young miss! You startled me!" 

The ghost leaps to his feet in an instant. He doesn't float but stands at ease. Other than a semi-transparent glow, there is nothing peculiar about him. This is what raises the alarm bells in your head.

>say hi
(to Tevarus)
There is no reply.

>hello
(Tevarus)
"Ho, young miss! You startled me!" 

The ghost leaps to his feet in an instant. He doesn't float but stands at ease. Other than a semi-transparent glow, there is nothing peculiar about him. This is what raises the alarm bells in your head.

* * *

>archives
That's not a verb I recognise.

>the archives
That's not a verb I recognise.

>help
That's not a verb I recognise.

>examine the archives
You can't see any such thing.

>x The Archives
You can't see any such thing.

>go
You'll have to say which compass direction to go in.

>go north
You can't go that way.

>go the archives
You can't see any such thing.

>look
Archives
The archives are located near the top of one of the smaller towers. Shelves high as the ceiling line the cylindrical walls, each of them crammed with records that are centuries old.

Seated at the single table by the window is Tevarus.

>look
Archives
The archives are located near the top of one of the smaller towers. Shelves high as the ceiling line the cylindrical walls, each of them crammed with records that are centuries old.

Seated at the single table by the window is Tevarus.

>look shelves
They look like they haven't been touched in years.

>look walls
You can't see any such thing.

>look records
You can't see any such thing.

>look table
It is made of wood, and is circular in dimension, more like the tables set out in the gardens than one used for extensive studying. It has a single chair, which Tevarus is occupying.

>look tevarus
He does not appear to have noticed you, his pensive gaze trained outside the window.

>look window
You can't see any such thing.

>look chair
It is fancy looking, guilded with leaves and intricate designs. Again, unlike the kind used for studying. Tevarus is currently occupying it, though you have no idea how this is possible as he is somewhat transparent.

>x chair
It is fancy looking, guilded with leaves and intricate designs. Again, unlike the kind used for studying. Tevarus is currently occupying it, though you have no idea how this is possible as he is somewhat transparent.

>x tevarus
He does not appear to have noticed you, his pensive gaze trained outside the window.

>sit in chair
It already seems to be occupied. Though Tevarus is a ghost I doubt it would be good manners to slide right through him to take the seat.

>hello
(Tevarus)
"Ho, young miss! You startled me!" 

The ghost leaps to his feet in an instant. He doesn't float but stands at ease. Other than a semi-transparent glow, there is nothing peculiar about him. This is what raises the alarm bells in your head.

>x chair
It is fancy looking, guilded with leaves and intricate designs. Again, unlike the kind used for studying.

>x tev
Tevarus is looking at you curiously.

>replay
That's not a verb I recognise.

>h
That's not a verb I recognise.

>end
That's not a verb I recognise.

>quit
Are you sure you want to quit?

* * *

>ask window
You can only do that to something animate.

>tev
That's not a verb I recognise.

>talk to tev
That's not a verb I recognise.

>talk to tevarus
That's not a verb I recognise.

>hello
(Tevarus)
"Ho, young miss! You startled me!" 

The ghost leaps to his feet in an instant. He doesn't float but stands at ease. Other than a semi-transparent glow, there is nothing peculiar about him. This is what raises the alarm bells in your head.

>ask about tevarus
You can't see any such thing.

>ask about ghost
You can't see any such thing.

>ask about table
You can't see any such thing.

>look
Archives
The archives are located near the top of one of the smaller towers. Shelves high as the ceiling line the cylindrical walls, each of them crammed with records that are centuries old.

Seated at the single table by the window is Tevarus.

>x
(Tevarus)
Tevarus is looking at you curiously.

>x me
As good-looking as ever.

* * *

>consider
I didn't understand that sentence.

>consider tevarus
So he's the ghost that haunts this tower?

>consider table
There is nothing to consider.

>consider
I didn't understand that sentence.

>consider archives
It's kind of filthy in a way that makes you itch, even if you've barely touched anything. You should start cleaning up soon.

>consider tower
This is one of the older towers of the castle, obvious in how long it's gone neglected.

>x tower
You can't see any such thing.

>x archives
You can't see any such thing.

>xx archive
That's not a verb I recognise.

>z
Time passes.

>help
   About
   Contacting the Author
 > How to Play
   About
   Contacting the Author
 > How to Play

* * *

>enter chair
It already seems to be occupied. Though Tevarus is a ghost I doubt it would be good manners to slide right through him to take the seat.

>hello
(addressing Tevarus)
"Ho, young miss! You startled me!" 

The ghost leaps to his feet in an instant. He doesn't float but stands at ease. Other than a semi-transparent glow, there is nothing peculiar about him. This is what raises the alarm bells in your head more.

>enter chair
It already seems to be occupied. Though Tevarus is a ghost I doubt it would be good manners to slide right through him to take the seat.

>enter chair
It already seems to be occupied. Though Tevarus is a ghost I doubt it would be good manners to slide right through him to take the seat.

>quit
Are you sure you want to quit?

* * *

>examine window
A single window with a stained glass pane hangs above the lone table in the room.

* * *

>hello
(Tevarus)
"Ho, young miss! You startled me!" 

The ghost leaps to his feet in an instant. He doesn't float but stands at ease. Other than a semi-transparent glow, there is nothing peculiar about him. This is what raises the alarm bells in your head.

>hello?
That's not a verb I recognise.

>x chair
It is fancy looking, guilded with leaves and intricate designs. Again, unlike the kind used for studying. Tevarus is currently occupying it, though you have no idea how this is possible as he is somewhat transparent.

>x table
It is made of wood, and is circular in dimension, more like the tables set out in the gardens than one used for extensive studying.

>x desk
It is made of wood, and is circular in dimension, more like the tables set out in the gardens than one used for extensive studying.

* * *

>hello
(Tevarus)
"Ho, young miss! You startled me!" 

The ghost leaps to his feet in an instant. He doesn't float but stands at ease. Other than a semi-transparent glow, there is nothing peculiar about him. This is what raises the alarm bells in your head.

>t hello
That's not a verb I recognise.

>tell tev hello
I didn't understand that sentence.

>hello tev
That's not a verb I recognise.

>Hello, Tev
You seem to want to talk to someone, but I can't see whom.

>Hello, Tevarus
You seem to want to talk to someone, but I can't see whom.

>Hello
That's not a verb I recognise.

>t hello
That's not a verb I recognise.

>hello, tevarus
You seem to want to talk to someone, but I can't see whom.

* * *

>x chair
It is fancy looking, guilded with leaves and intricate designs. Again, unlike the kind used for studying.

>x chair
It is fancy looking, guilded with leaves and intricate designs. Again, unlike the kind used for studying.

* * *

>x tev
Tevarus is looking at you curiously.

>enter chair
Tevarus is looking at you with surprise. Perhaps it would be best to continue speaking with him.

* * *

>hello?
That's not a verb I recognise.

>hello
(Tevarus)
"Ho, young miss! You startled me!" 

The ghost leaps to his feet in an instant. He doesn't float but stands at ease. Other than a semi-transparent glow, there is nothing peculiar about him. This is what raises the alarm bells in your head.

>x
(Tevarus)
Tevarus is looking at you curiously.

>x
(Tevarus)
Tevarus is looking at you curiously.

>xchair
That's not a verb I recognise.

>x chair
It is fancy looking, guilded with leaves and intricate designs.

>x chair
It is fancy looking, guilded with leaves and intricate designs.

>x table
It is made of wood, and is circular in dimension, more like the tables set out in the gardens than one used for extensive studying. It has a single chair, which Tevarus is occupying.

* * *

>help
Archives
The archives are located near the top of one of the smaller towers. Shelves high as the ceiling line the cylindrical walls, each of them crammed with records that are centuries old.

Seated at the single table by the window is Tevarus.

>help
Archives
The archives are located near the top of one of the smaller towers. Shelves high as the ceiling line the cylindrical walls, each of them crammed with records that are centuries old.

Seated at the single table by the window is Tevarus.

>examine self
As good-looking as ever.

>examine
(Tevarus)
He does not appear to have noticed you, his pensive gaze trained outside the window.

>x window
A single window with a stained glass pane hangs above the lone table in the room.

>l self
As good-looking as ever.

>l tev
He does not appear to have noticed you, his pensive gaze trained outside the window. Maybe you should try to get his attention.

>l window
A single window with a stained glass pane hangs above the lone table in the room.

>l archives
You can't see any such thing.

>l
Archives
The archives are located near the top of one of the smaller towers. Shelves high as the ceiling line the cylindrical walls, each of them crammed with records that are centuries old.

Seated at the single table by the window is Tevarus.

>l
Archives
The archives are located near the top of one of the smaller towers. Shelves high as the ceiling line the cylindrical walls, each of them crammed with records that are centuries old.

Seated at the single table by the window is Tevarus.

>l shelves
They look like they haven't been touched in years.

>touch shelves
You feel nothing unexpected.

>t
That's not a verb I recognise.

>touch
(Tevarus)
Tevarus might not like that.

>look
Archives
The archives are located near the top of one of the smaller towers. Shelves high as the ceiling line the cylindrical walls, each of them crammed with records that are centuries old.

Seated at the single table by the window is Tevarus.

>smell
You smell nothing unexpected.

>listen
You hear nothing unexpected.

>examine
(Tevarus)
He does not appear to have noticed you, his pensive gaze trained outside the window. Maybe you should try to get his attention.

>examine window
A single window with a stained glass pane hangs above the lone table in the room.

>x glass
It is very colorful.

>x table
It is made of wood, and is circular in dimension, more like the tables set out in the gardens than one used for extensive studying. It has a single chair, which Tevarus is occupying.

>x chair
It is fancy looking, guilded with leaves and intricate designs. Again, unlike the kind used for studying. Tevarus is currently occupying it, though you have no idea how this is possible as he is somewhat transparent.

>sit on table
That's not something you can sit down on.

>enter table
That's not something you can enter.

>enter chair
It already seems to be occupied. Though Tevarus is a ghost I doubt it would be good manners to slide right through him to take the seat.

>help ghost
I only understood you as far as wanting to help.

>help
Archives
The archives are located near the top of one of the smaller towers. Shelves high as the ceiling line the cylindrical walls, each of them crammed with records that are centuries old.

Seated at the single table by the window is Tevarus.

>help ghost
I only understood you as far as wanting to help.

>enter chair
It already seems to be occupied. Though Tevarus is a ghost I doubt it would be good manners to slide right through him to take the seat.

>scream
(at Tevarus)
Your eyes widen and your heartbeat speeds up. Before you realize it, a blood-curdling scream rips out of your throat. 

  Tevarus is startled out of his seat, his surprised gaze intent on you. When you look back on this moment when you are significantly calmer, you think that he might have tried to say something to you. Right now, you are too hopped up on adrenaline to think about anything except that there is a ghost in the Archives. 

 In a thrice, you are out of there and in the middle of the courtyard, clinging to your superiors and babbling about hauntings. 

 Instead of sharing your horror, they sigh and reassign you to a different task.

    *** You have completed the Scared ending ***

Would you like to RESTART, RESTORE a saved game, QUIT or UNDO the last command?

* * *

>help
Archives
The archives are located near the top of one of the smaller towers. Shelves high as the ceiling line the cylindrical walls, each of them crammed with records that are centuries old.

Seated at the single table by the window is Tevarus.

>scream
(at Tevarus)
Your eyes widen and your heartbeat speeds up. Before you realize it, a blood-curdling scream rips out of your throat. 

  Tevarus is startled out of his seat, his surprised gaze intent on you. When you look back on this moment when you are significantly calmer, you think that he might have tried to say something to you. Right now, you are too hopped up on adrenaline to think about anything except that there is a ghost in the Archives. 

 In a thrice, you are out of there and in the middle of the courtyard, clinging to your superiors and babbling about hauntings. 

 Instead of sharing your horror, they sigh and reassign you to a different task.

    *** You have completed the Scared ending ***

Would you like to RESTART, RESTORE a saved game, QUIT or UNDO the last command?

* * *

>look
Gazebo
A white canvas parasol raised up on stakes driven into the grass.

>x
What do you want to examine?

>x gazebo
You can't see any such thing.

>x parasol
You can't see any such thing.

* * *

>look the archives
You can't see any such thing.

>look archives
You can't see any such thing.

>look Archives
You can't see any such thing.

>Archives
That's not a verb I recognise.

>look
Archives
The archives are located near the top of one of the smaller towers. Shelves high as the ceiling line the cylindrical walls, each of them crammed with records that are centuries old.

Seated at the single table by the window is Tevarus.

>x tev
He does not appear to have noticed you, his pensive gaze trained outside the window.

>x tev
He does not appear to have noticed you, his pensive gaze trained outside the window.

>x window
You can't see any such thing.

>x chair
It is fancy looking, guilded with leaves and intricate designs. Again, unlike the kind used for studying. Tevarus is currently occupying it, though you have no idea how this is possible as he is somewhat transparent.

>x table
It is made of wood, and is circular in dimension, more like the tables set out in the gardens than one used for extensive studying. It has a single chair, which Tevarus is occupying.

>x tevarus
He does not appear to have noticed you, his pensive gaze trained outside the window.

>greet
(Tevarus)
"Ho, young miss! You startled me!" 

The ghost leaps to his feet in an instant. He doesn't float but stands at ease. Other than a semi-transparent glow, there is nothing peculiar about him. This is what raises the alarm bells in your head.

>x tev
Tevarus is looking at you curiously.

* * *

>scream
(at Tevarus)
Your eyes widen and your heartbeat speeds up. Before you realize it, a blood-curdling scream rips out of your throat.

Tevarus is startled out of his seat, his surprised gaze intent on you. When you look back on this moment when you are significantly calmer, you think that he might have tried to say something to you. Right now, you are too hopped up on adrenaline to think about anything except that there is a ghost in the Archives.

 In a thrice, you are out of there and in the middle of the courtyard, clinging to your superiors and babbling about hauntings.

 Instead of sharing your horror, they sigh and reassign you to a different task.

    *** You have completed the Scared ending ***

Would you like to RESTART, RESTORE a saved game, QUIT or UNDO the last command?

>greeting
That's not a verb I recognise.

* * *

>restart
You are a newly appointed historian and your first job is to clean up the archives. This is where you stumble upon the ghost of Tevarus of Tanner, a former aristocrat with very little recorded history to his name. The only thing you remember about him is the fact that he died a traitor's death.

He does not seem dangerous and neither does he appear to have noticed you.

Tevarus
An attempt at IF. by anonabelle
Release 1 / Serial number 241210 / Inform 7 v10.1.2 / D

Archives
The archives are located near the top of one of the smaller towers. Shelves high as the ceiling line the cylindrical walls, each of them crammed with records that are centuries old - and smells it. Maybe you should air out the room.

Seated at the single table by the window is Tevarus.

>greet
(Tevarus)
"Ho, young miss! You startled me!" 

The ghost leaps to his feet in an instant. He doesn't float but stands at ease. Other than a semi-transparent glow, there is nothing peculiar about him. This is what raises the alarm bells in your head.

>scream
(at Tevarus)
Your eyes widen and your heartbeat speeds up. Before you realize it, a blood-curdling scream rips out of your throat.

Tevarus's surprised expression turns into one of confusion and concern. When you look back on this moment when you are significantly calmer, you think that he might have tried to say something to you. Right now, you are too hopped up on adrenaline to think about anything except that there is a ghost in the Archives.

 In a thrice, you are out of there and in the middle of the courtyard, clinging to your superiors and babbling about hauntings.

 Instead of sharing your horror, they sigh and reassign you to a different task.

    *** You have completed the Scared ending ***

Would you like to RESTART, RESTORE a saved game, QUIT or UNDO the last command?

>restart
You are a newly appointed historian and your first job is to clean up the archives. This is where you stumble upon the ghost of Tevarus of Tanner, a former aristocrat with very little recorded history to his name. The only thing you remember about him is the fact that he died a traitor's death.

He does not seem dangerous and neither does he appear to have noticed you.

Tevarus
An attempt at IF. by anonabelle
Release 1 / Serial number 241210 / Inform 7 v10.1.2 / D

Archives
The archives are located near the top of one of the smaller towers. Shelves high as the ceiling line the cylindrical walls, each of them crammed with records that are centuries old - and smells it. Maybe you should air out the room.

Seated at the single table by the window is Tevarus.

>scream
(at Tevarus)
Your eyes widen and your heartbeat speeds up. Before you realize it, a blood-curdling scream rips out of your throat.

Tevarus is startled out of his seat, his surprised gaze intent on you. When you look back on this moment when you are significantly calmer, you think that he might have tried to say something to you. Right now, you are too hopped up on adrenaline to think about anything except that there is a ghost in the Archives.

 In a thrice, you are out of there and in the middle of the courtyard, clinging to your superiors and babbling about hauntings.

 Instead of sharing your horror, they sigh and reassign you to a different task.

    *** You have completed the Scared ending ***

Would you like to RESTART, RESTORE a saved game, QUIT or UNDO the last command?

* * *

>help tevarus
I only understood you as far as wanting to help.

>hint
Archives
The archives are located near the top of one of the smaller towers. Shelves high as the ceiling line the cylindrical walls, each of them crammed with records that are centuries old - and smells it. Maybe you should air out the room.

Seated at the single table by the window is Tevarus.

>info\
That's not a verb I recognise.

>info
Archives
The archives are located near the top of one of the smaller towers. Shelves high as the ceiling line the cylindrical walls, each of them crammed with records that are centuries old.

Seated at the single table by the window is Tevarus.

>l
Archives
The archives are located near the top of one of the smaller towers. Shelves high as the ceiling line the cylindrical walls, each of them crammed with records that are centuries old.

Seated at the single table by the window is Tevarus.

>i
You are carrying nothing.

>inventory
You are carrying nothing.

>take chair
That's hardly portable.

* * *

>hello
(Tevarus)
"Ho, young miss! You startled me!" 

The ghost leaps to his feet in an instant. He doesn't float but stands at ease. Other than a semi-transparent glow, there is nothing peculiar about him. This is what raises the alarm bells in your head.

>scream
(at Tevarus)
Your eyes widen and your heartbeat speeds up. Before you realize it, a blood-curdling scream rips out of your throat.

 Tevarus's surprised expression turns into one of confusion and concern. When you look back on this moment when you are significantly calmer, you think that he might have tried to say something to you. Right now, you are too hopped up on adrenaline to think about anything except that there is a ghost in the Archives.

 In a thrice, you are out of there and in the middle of the courtyard, clinging to your superiors and babbling about hauntings.

 Instead of sharing your horror, they sigh and reassign you to a different task.

    *** You have completed the Scared ending ***

Would you like to RESTART, RESTORE a saved game, QUIT or UNDO the last command?

* * *

>scream
(at Tevarus)
Your eyes widen and your heartbeat speeds up. Before you realize it, a blood-curdling scream rips out of your throat. Tevarus is startled out of his seat, his surprised gaze intent on you.
 When you look back on this moment when you are significantly calmer, you think that he might have tried to say something to you. Right now, you are too hopped up on adrenaline to think about anything except that there is a ghost in the Archives.

In a thrice, you are out of there and in the middle of the courtyard, clinging to your superiors and babbling about hauntings. Instead of sharing your horror, they sigh and reassign you to a different task.

    *** You have completed the Scared ending ***

Would you like to RESTART, RESTORE a saved game, QUIT or UNDO the last command?

>restart
You are a newly appointed historian and your first job is to clean up the archives. This is where you stumble upon the ghost of Tevarus of Tanner, a former aristocrat with very little recorded history to his name. The only thing you remember about him is the fact that he died a traitor's death.

He does not seem dangerous and neither does he appear to have noticed you.

Tevarus
An attempt at IF. by anonabelle
Release 1 / Serial number 241206 / Inform 7 v10.1.2 / D

Archives
The archives are located near the top of one of the smaller towers. Shelves high as the ceiling line the cylindrical walls, each of them crammed with records that are centuries old.

Seated at the single table by the window is Tevarus.

>greet
(Tevarus)
"Ho, young miss! You startled me!" 

The ghost leaps to his feet in an instant. He doesn't float but stands at ease. Other than a semi-transparent glow, there is nothing peculiar about him. This is what raises the alarm bells in your head.

>scream
(at Tevarus)
Your eyes widen and your heartbeat speeds up. Before you realize it, a blood-curdling scream rips out of your throat. Tevarus's surprised expression turns into one of confusion and concern.
 When you look back on this moment when you are significantly calmer, you think that he might have tried to say something to you. Right now, you are too hopped up on adrenaline to think about anything except that there is a ghost in the Archives.

In a thrice, you are out of there and in the middle of the courtyard, clinging to your superiors and babbling about hauntings. Instead of sharing your horror, they sigh and reassign you to a different task.

    *** You have completed the Scared ending ***

Would you like to RESTART, RESTORE a saved game, QUIT or UNDO the last command?

* * *

>x tevarus
He does not appear to have noticed you, his pensive gaze trained outside the window.

>hello
(Tevarus)
"Ho, young miss! You startled me!" 

The ghost leaps to his feet in an instant. He doesn't float but stands at ease. Other than a semi-transparent glow, there is nothing peculiar about him. This is what raises the alarm bells in your head.

>x tevarus
Tevarus is looking at you curiously.

* * *

>scream at tev
I only understood you as far as wanting to scream.

>scream
You must supply a noun.

>scream tev
I only understood you as far as wanting to scream.

>scream
You must supply a noun.

* * *

>think
What a good idea.

>thinking
That's not a verb I recognise.

>think about
I only understood you as far as wanting to think.

>think about tev
I only understood you as far as wanting to think.

>think about tevarus
I only understood you as far as wanting to think.

>think tevarus
I only understood you as far as wanting to think.

* * *

>x archives
You can't see any such thing.

>look archives
You can't see any such thing.

>go to archives
You can't see any such thing.

* * *

>x archives
You can't see any such thing.

>x table
It is made of wood, and is circular in dimension, more like the tables set out in the gardens than one used for extensive studying. It has a single chair, which Tevarus is occupying.

>x table
It is made of wood, and is circular in dimension, more like the tables set out in the gardens than one used for extensive studying. It has a single chair, which Tevarus is occupying.

* * *

>x chair
It is fancy looking, guilded with leaves and intricate designs. Again, unlike the kind used for studying. Tevarus is currently occupying it, though you have no idea how this is possible as he is somewhat transparent.

>x chair
It is fancy looking, guilded with leaves and intricate designs. Again, unlike the kind used for studying. Tevarus is currently occupying it, though you have no idea how this is possible as he is somewhat transparent.

>x tev
He does not appear to have noticed you, his pensive gaze trained outside the window.

>x tev
He does not appear to have noticed you, his pensive gaze trained outside the window. Maybe you should try to get his attention.

>x tev
He does not appear to have noticed you, his pensive gaze trained outside the window. Maybe you should try to get his attention.

>hi
That's not a verb I recognise.

>hello
(Tevarus)
"Ho, young miss! You startled me!" 

The ghost leaps to his feet in an instant. He doesn't float but stands at ease. Other than a semi-transparent glow, there is nothing peculiar about him. This is what raises the alarm bells in your head.

>x tev
Tevarus is looking at you curiously.Maybe you should try to get his attention.

* * *

>x archives
You can't see any such thing.

>x tower
You can't see any such thing.

>think about tower
I only understood you as far as wanting to think.

>think tower
I only understood you as far as wanting to think.

>x shelves
They look like they haven't been touched in years.

>x walls
You can't see any such thing.

>x ceiling
You can't see any such thing.

>x records
You can't see any such thing.

>x books
You can't see any such thing.

>x table
It is made of wood, and is circular in dimension, more like the tables set out in the gardens than one used for extensive studying. It has a single chair, which Tevarus is occupying.

* * *

>x chair
It is fancy looking, guilded with leaves and intricate designs. Again, unlike the kind used for studying. Tevarus is currently occupying it, though you have no idea how this is possible as he is somewhat transparent.

>x Tevarus
He does not appear to have noticed you, his pensive gaze trained outside the window.

>x window
You can't see any such thing.

>enter
It already seems to be occupied. Though Tevarus is a ghost I doubt it would be good manners to slide right through him to take the seat.

>enter chair
It already seems to be occupied. Though Tevarus is a ghost I doubt it would be good manners to slide right through him to take the seat.

>sit on chair
It already seems to be occupied. Though Tevarus is a ghost I doubt it would be good manners to slide right through him to take the seat.

>sit
(on Tevarus)
That's not something you can sit down on.

>sit on chair
It already seems to be occupied. Though Tevarus is a ghost I doubt it would be good manners to slide right through him to take the seat.

* * *

>x desk
It is made of wood, and is circular in dimension, more like the tables set out in the gardens than one used for extensive studying. It has a single chair, which Tevarus is occupying.

>x desk
It is made of wood, and is circular in dimension, more like the tables set out in the gardens than one used for extensive studying. It has a single chair, which Tevarus is occupying.

>x chair
It is fancy looking, guilded with leaves and intricate designs. Again, unlike the kind used for studying. Tevarus is currently occupying it, though you have no idea how this is possible as he is somewhat transparent.

>sit chair
I didn't understand that sentence.

>sit in chair
It already seems to be occupied. Though Tevarus is a ghost I doubt it would be good manners to slide right through him to take the seat.

>sit in chair
It already seems to be occupied. Though Tevarus is a ghost I doubt it would be good manners to slide right through him to take the seat.

>x tev
He does not appear to have noticed you, his pensive gaze trained outside the window.

* * *

>x tev
He does not appear to have noticed you, his pensive gaze trained outside the window. Maybe you should try to get his attention.

>x chair
It is fancy looking, guilded with leaves and intricate designs. Again, unlike the kind used for studying. Tevarus is currently occupying it, though you have no idea how this is possible as he is somewhat transparent.

>hello
(Tevarus)
"Ho, young miss! You startled me!" 

The ghost leaps to his feet in an instant. He doesn't float but stands at ease. Other than a semi-transparent glow, there is nothing peculiar about him. This is what raises the alarm bells in your head.

>x desk
It is made of wood, and is circular in dimension, more like the tables set out in the gardens than one used for extensive studying. It has a single chair.

>x chair
It is fancy looking, guilded with leaves and intricate designs. Again, unlike the kind used for studying.

>hello
(Tevarus)
"Ho, young miss! You startled me!" 

The ghost leaps to his feet in an instant. He doesn't float but stands at ease. Other than a semi-transparent glow, there is nothing peculiar about him. This is what raises the alarm bells in your head.

>x tev
Tevarus is looking at you curiously.

* * *

>x records
They are everywhere and coated in a thick layer of dust.

>x records
They are everywhere and coated in a thick layer of dust.

* * *

>x shelves
They look like they haven't been touched in years.

>x table
It is made of wood, and is circular in dimension, more like the tables set out in the gardens than one used for extensive studying. It has a single chair, which Tevarus is occupying.

* * *

>x chair
It is fancy looking, guilded with leaves and intricate designs. Again, unlike the kind used for studying. Tevarus is currently occupying it, though you have no idea how this is possible as he is somewhat transparent.

>enter chair
It already seems to be occupied. Though Tevarus is a ghost I doubt it would be good manners to slide right through him to take the seat.

>x tev
He does not appear to have noticed you, his pensive gaze trained outside the window.

* * *

>x tev
He does not appear to have noticed you, his pensive gaze trained outside the window. Maybe you should try to get his attention.

>hello
(addressing Tevarus)
"Ho, young miss! You startled me!"

 The ghost leaps to his feet, which appear to be planted quite firmly on the ground. He doesn't float but stands at ease. Other than a semi-transparent glow, there is nothing peculiar about him. This is what raises the alarm bells in your head more.

* * *

>x tev
He does not appear to have noticed you, his pensive gaze trained outside the window.

>hello
(Tevarus)
"Ho, young miss! You startled me!" 

The ghost leaps to his feet in an instant. He doesn't float but stands at ease. Other than a semi-transparent glow, there is nothing peculiar about him. This is what raises the alarm bells in your head.

>look
Archives
The archives are located near the top of one of the smaller towers. Shelves high as the ceiling line the cylindrical walls, each of them crammed with records that are centuries old - and smells it. Maybe you should air out the room.

Tevarus is standing by the lone table in the room, watching you curiously.

>x tev
Tevarus is looking at you curiously.

>x tev
Tevarus is looking at you curiously.

* * *

>x tev
He does not appear to have noticed you, his pensive gaze trained outside the window.

>scream
(at Tevarus)
Your eyes widen and your heartbeat speeds up. Before you realize it, a blood-curdling scream rips out of your throat.

 Tevarus is startled out of his seat, his surprised gaze intent on you.
 When you look back on this moment when you are significantly calmer, you think that he might have tried to say something to you. Right now, you are too hopped up on adrenaline to think about anything except that there is a ghost in the Archives.

In a thrice, you are out of there and in the middle of the courtyard, clinging to your superiors and babbling about hauntings. Instead of sharing your horror, they sigh and reassign you to a different task.

    *** You have completed the Scared ending ***

Would you like to RESTART, RESTORE a saved game, QUIT or UNDO the last command?

>restart
You are a newly appointed historian and your first job is to clean up the archives. This is where you stumble upon the ghost of Tevarus of Tanner, a former aristocrat with very little recorded history to his name. The only thing you remember about him is the fact that he died a traitor's death.

He does not seem dangerous and neither does he appear to have noticed you.

Tevarus
An attempt at IF. by anonabelle
Release 1 / Serial number 241206 / Inform 7 v10.1.2 / D

Archives
The archives are located near the top of one of the smaller towers. Shelves high as the ceiling line the cylindrical walls, each of them crammed with records that are centuries old.

Seated at the single table by the window is Tevarus.

>scream at tevarus
Your eyes widen and your heartbeat speeds up. Before you realize it, a blood-curdling scream rips out of your throat.

 Tevarus is startled out of his seat, his surprised gaze intent on you.
 When you look back on this moment when you are significantly calmer, you think that he might have tried to say something to you. Right now, you are too hopped up on adrenaline to think about anything except that there is a ghost in the Archives.

In a thrice, you are out of there and in the middle of the courtyard, clinging to your superiors and babbling about hauntings. Instead of sharing your horror, they sigh and reassign you to a different task.

    *** You have completed the Scared ending ***

Would you like to RESTART, RESTORE a saved game, QUIT or UNDO the last command?

>scream
Please give one of the answers above.

Would you like to RESTART, RESTORE a saved game, QUIT or UNDO the last command?

>restart
You are a newly appointed historian and your first job is to clean up the archives. This is where you stumble upon the ghost of Tevarus of Tanner, a former aristocrat with very little recorded history to his name. The only thing you remember about him is the fact that he died a traitor's death.

He does not seem dangerous and neither does he appear to have noticed you.

Tevarus
An attempt at IF. by anonabelle
Release 1 / Serial number 241206 / Inform 7 v10.1.2 / D

Archives
The archives are located near the top of one of the smaller towers. Shelves high as the ceiling line the cylindrical walls, each of them crammed with records that are centuries old.

Seated at the single table by the window is Tevarus.

>scream
(at Tevarus)
Your eyes widen and your heartbeat speeds up. Before you realize it, a blood-curdling scream rips out of your throat.

 Tevarus is startled out of his seat, his surprised gaze intent on you.
 When you look back on this moment when you are significantly calmer, you think that he might have tried to say something to you. Right now, you are too hopped up on adrenaline to think about anything except that there is a ghost in the Archives.

In a thrice, you are out of there and in the middle of the courtyard, clinging to your superiors and babbling about hauntings. Instead of sharing your horror, they sigh and reassign you to a different task.

    *** You have completed the Scared ending ***

Would you like to RESTART, RESTORE a saved game, QUIT or UNDO the last command?

* * *

>x wall
Solid stone bricks. They've got a weathered, century-old look about them that you've seen in similar old, hidden-away rooms.

>x walls
Solid stone bricks. They've got a weathered, century-old look about them that you've seen in similar old, hidden-away rooms.

>x archives
You can't see any such thing.

* * *

>look at archives
You can't see any such thing.

>look
Archives
The archives are located near the top of one of the smaller towers. Shelves high as the ceiling line the cylindrical walls, each of them crammed with records that are centuries old.

Seated at the single table by the window is Tevarus.

>x shelves
They look like they haven't been touched in years.

>x records
You can't see any such thing.

>x table
It is made of wood, and is circular in dimension, more like the tables set out in the gardens than one used for extensive studying. It has a single chair, which Tevarus is occupying.

>x tev
He does not appear to have noticed you, his pensive gaze trained outside the window.

* * *

>hello
(Tevarus)
"Ho, young miss! You startled me!" 

The ghost leaps to his feet in an instant. He doesn't float but stands at ease. Other than a semi-transparent glow, there is nothing peculiar about him. This is what raises the alarm bells in your head.

>scream
(at Tevarus)
Your eyes widen and your heartbeat speeds up. Before you realize it, a blood-curdling scream rips out of your throat.

 Tevarus" surprised expression turns into one of confusion and concern.
 When you look back on this moment when you are significantly calmer, you think that he might have tried to say something to you. Right now, you are too hopped up on adrenaline to think about anything except that there is a ghost in the Archives.

In a thrice, you are out of there and in the middle of the courtyard, clinging to your superiors and babbling about hauntings. Instead of sharing your horror, they sigh and reassign you to a different task.

    *** You have completed the Scared ending ***

Would you like to RESTART, RESTORE a saved game, QUIT or UNDO the last command?

>restart
You are a newly appointed historian and your first job is to clean up the archives. This is where you stumble upon the ghost of Tevarus of Tanner, a former aristocrat with very little recorded history to his name. The only thing you remember about him is the fact that he died a traitor's death.

He does not seem dangerous and neither does he appear to have noticed you.

Tevarus
An attempt at IF. by anonabelle
Release 1 / Serial number 241206 / Inform 7 v10.1.2 / D

Archives
The archives are located near the top of one of the smaller towers. Shelves high as the ceiling line the cylindrical walls, each of them crammed with records that are centuries old.

Seated at the single table by the window is Tevarus.

* * *

>greet
(Tevarus)
"Ho, young miss! You startled me!" 

The ghost leaps to his feet in an instant. He doesn't float but stands at ease. Other than a semi-transparent glow, there is nothing peculiar about him. This is what raises the alarm bells in your head.

>scream
(at Tevarus)
Your eyes widen and your heartbeat speeds up. Before you realize it, a blood-curdling scream rips out of your throat.

 Tevarus" surprised expression turns into one of confusion and concern.
 When you look back on this moment when you are significantly calmer, you think that he might have tried to say something to you. Right now, you are too hopped up on adrenaline to think about anything except that there is a ghost in the Archives.

In a thrice, you are out of there and in the middle of the courtyard, clinging to your superiors and babbling about hauntings. Instead of sharing your horror, they sigh and reassign you to a different task.

    *** You have completed the Scared ending ***

Would you like to RESTART, RESTORE a saved game, QUIT or UNDO the last command?

* * *

>x tev
He does not appear to have noticed you, his pensive gaze trained outside the window.

>x chair
It is fancy looking, guilded with leaves and intricate designs.  Tevarus is currently occupying it, though you have no idea how this is possible as he is somewhat transparent.

>x chair
It is fancy looking, guilded with leaves and intricate designs.  Tevarus is currently occupying it, though you have no idea how this is possible as he is somewhat transparent.

>x desk
It is made of wood, and is circular in dimension, more like the tables set out in the gardens than one used for extensive studying. It has a single chair, which Tevarus is occupying.

* * *

>x chair
It is fancy looking, guilded with leaves and intricate designs. Again, unlike the kind used for studying. Tevarus is currently occupying it, though you have no idea how this is possible as he is somewhat transparent.

>x tev
He does not appear to have noticed you, his pensive gaze trained outside the window. Maybe you should try to get his attention.

>hello?
That's not a verb I recognise.

* * *

>x tev
He does not appear to have noticed you, his pensive gaze trained outside the window.

>x tev
He does not appear to have noticed you, his pensive gaze trained outside the window.  Maybe you should try to get his attention.

>hello
(Tevarus)
"Ho, young miss! You startled me!" 

The ghost leaps to his feet in an instant. He doesn't float but stands at ease. Other than a semi-transparent glow, there is nothing peculiar about him. This is what raises the alarm bells in your head.

>x tev
Tevarus is looking at you curiously. Maybe you should try to get his attention.

>x tev
Tevarus is looking at you curiously. Maybe you should try to get his attention.

* * *

>x tev
He does not appear to have noticed you, his pensive gaze trained outside the window.  Maybe you should try to get his attention.

>x tev
He does not appear to have noticed you, his pensive gaze trained outside the window.

* * *

>x window
You can't see any such thing.

>x
(Tevarus)
He does not appear to have noticed you, his pensive gaze trained outside the window. Maybe you should try to get his attention.

>hello
(Tevarus)
"Ho, young miss! You startled me!" 

The ghost leaps to his feet in an instant. He doesn't float but stands at ease. Other than a semi-transparent glow, there is nothing peculiar about him. This is what raises the alarm bells in your head.

* * *

>x tev
Tevarus is looking at you curiously.

>x
(Tevarus)
Tevarus is looking at you curiously.

>look
Archives
The archives are located near the top of one of the smaller towers. Shelves high as the ceiling line the cylindrical walls, each of them crammed with records that are centuries old.

Seated at the single table by the window is Tevarus.

>x chair
It is fancy looking, guilded with leaves and intricate designs. Again, unlike the kind used for studying.

>x desk
It is made of wood, and is circular in dimension, more like the tables set out in the gardens than one used for extensive studying. It has a single chair, which Tevarus is occupying.

* * *

>x tevarus
He does not appear to have noticed you, his pensive gaze trained outside the window.

>x tevarus
He does not appear to have noticed you, his pensive gaze trained outside the window. Maybe you should try to get his attention.

>x table
It is made of wood, and is circular in dimension, more like the tables set out in the gardens than one used for extensive studying. It has a single chair, which Tevarus is occupying.

* * *

>x chair
It is fancy looking, guilded with leaves and intricate designs. Again, unlike the kind used for studying. Tevarus is currently occupying it, though you have no idea how this is possible as he is somewhat transparent.

>enter chair
It already seems to be occupied. Though Tevarus is a ghost I doubt it good manners to slide right through him and take the seat.

* * *

>x tevarus
He does not appear to have noticed you, his pensive gaze trained outside the window. Maybe you should try to get his attention.

>z
Time passes.

>x table
It is made of wood, and is circular in dimension, more like the tables set out in the gardens than one used for extensive studying.

* * *

>x walls
Solid stone bricks. They've got a weathered, century-old look about them that you've seen in similar old, hidden-away rooms.

>x wall
Solid stone bricks. They've got a weathered, century-old look about them that you've seen in similar old, hidden-away rooms.

* * *

>x window
A single window with a stained glass pane hangs above the lone table in the room. It's shut tight.

>open window
Tevarus is directly in the way. Maybe you should talk to him first.

>x tevarus
He does not appear to have noticed you, his pensive gaze trained outside the window.

* * *

>hello
(Tevarus)
"Ho, young miss! You startled me!" 

The ghost leaps to his feet in an instant. He doesn't float but stands at ease. Other than a semi-transparent glow, there is nothing peculiar about him. This is what raises the alarm bells in your head.

>ask ghost
You can't see any such thing.

>ask about ghost
You can't see any such thing.

>ask tevarus about ghost
Tevarus looks apologetic. "I dont know how I came to be like this. I just know that I've been this way for a very long time."

>a tev about ghost
That's not a verb I recognise.

>ask tev
(for Tevarus)
(Tevarus first taking Tevarus)
Tevarus has better things to do.

>ask tev ghost
I didn't understand that sentence.

>ask tev about ghost
Tevarus looks apologetic. "I dont know how I came to be like this. I just know that I've been this way for a very long time."

* * *

>x window
A single window with a stained glass pane hangs above the lone table in the room. It's shut tight.

>x stained glass pane
It is very colorful.

>open window
Tevarus is directly in the way. Maybe you should talk to him first.

>hello
(Tevarus)
"Ho, young miss! You startled me!" 

The ghost leaps to his feet in an instant. He doesn't float but stands at ease. Other than a semi-transparent glow, there is nothing peculiar about him. This is what raises the alarm bells in your head.

>open window
Maybe you can try to air out the room when Tevarus is not standing in between you and the window.

>ask about window
You can't see any such thing.

>ask window
You can only do that to something animate.

>ask tevarus
(for Tevarus)
(Tevarus first taking Tevarus)
Tevarus has better things to do.

>ask window
You can only do that to something animate.